R 800 600
NO ./textures/mossy.xpm
SO ./textures/blood.xpm
WE ./textures/iron.xpm
EA ./textures/wood.xpm

S ./textures/guard.xpm
F 39, 40, 43
C 7, 0, 31

11111111111111111111111
10000000000000000000001
10E00000000000000000201
10000000000000000000001
11111111111111111000001
10000000002000000000001
10000000000000000000001
10000011111111111000001
10000010000010000000001
10200000000000002000001
10000000000000000000001
11111111111111111000001
10000000000000000000001
10200000000000000000001
10000000000000000000001
10200000000000000000001
10000000111111111111111
10000000100020200000001
11110000100202020000001
10000000100000000000201
10000000000000000000001
11110000000000000000201
10000020111111111100001
11111111111111111111111
